Rachel: Benjamin, Arthur S, Arthur L, Alexandre B, Nael
Arthur S: Rachel, Claudia, Camille S, Marion G, Sara R
Claudia: Arthur S, Cyril G
Benjamin: Rachel, Coline
Alexandre B: Thiphaine, Rachel
Célia: Diego, Bellomo
Arthur L: Rachel, Camille S, Simon L, Mahaut
Nael: Rachel, Léa B
Coline: Benjamin, Mathys, Sacha, Robin
Sacha: Emilie M, Léa B, Romane Bleu, Coline
Robin: Juliette M, Coline
Juliette M: Illian, Robin, Thibaut, Lepage, Remi, Remy
Thibaut: Juliette M, Emilie S, Ann-So
Emilie S: Thibaut, Baptiste H, Baptiste
Baptiste: Emilie S, Soledhie
Illian: Isaline R, Lilly, Juliette M, Nadia, Mahaut
Léa B: Nael, Sacha, Bleu Bouc
Simon L: Arthur L
Odile: Marvin
Nathan: Jane
Toine: Eline D
Alex P: Leo O, Myrdin
Juliette Menne: Isidore
Thiphaine: Stef, Alexandre B
Thomas O: Lea G
Camille S: Victor Louys, Arthur L, Madhi, Arthur S, Bastien
Mahaut: Illian, Arthur L
Clemrog: Juliette W, Lucie Lhotelerie
Lea Lahaye: Matthis P
Marvin: Cambric, Odile, Louanne
Juliette W: Clemrog
Nadia: Illian, Theo Duvelliez
Isidore: Diego, Juliette Menne, Lilly
Eline D: Bellomo, Toine
Marion G: Arthur S, Leo O
Jeanjean: Anto, Diego, Yannick, Baptiste H
Lilly: Forest, Illian, Isidore, Devos
Isaline R: Illian, Stef, Myrdin
Stef: Isaline R, Isaline D, Thiphaine, Amandine
Isaline D: Guillaume G, Stef, Arthur D, Bastien, Matthis B
Remy: Juliette M, Lea N
Lea N: Etienne, Diego, Remy
Diego: Lola T, Jeanjean, Margaux M, Lea N, Cambric, Célia, Isidore, Sara R
Devos: Lilly
Forest: Alice L, Lilly
Etienne: Alice H, Lea N
Myrdin: Alice H, Isaline R, Zoé G, Emilie M, Alex P
Bellomo: Eline D, Célia
Bastien: Camille S, Isaline D
Henri: Lison, Noemie
Lison: Henri, Valentin, Leo O
Leo O: Alex P, Marion G, Zoé G, Lison
Cyril G: Claudia
Mathys: Coline
Emilie M: Sacha, Myrdin
Romane Bleu: Sacha
Thibaut: Juliette M
Lepage: Juliette M
Remi: Juliette M
Ann-So: Thibaut
Baptiste H: Emilie S, Jeanjean
Soledhie: Baptiste
Bleu Bouc: Léa B
Jane: Nathan
Lea G: Thomas O
Victor Louys: Camille S
Madhi: Camille S
Lucie Lhotelerie: Clemrog
Matthis P: Lea Lahaye
Cambric: Marvin, Diego
Louanne: Marvin
Theo Duvelliez: Nadia
Anto: Jeanjean, Anto
Yannick: Jeanjean
Amandine: Stef
Guillaume G: Isaline D
Arthur D: Isaline D
Matthis B: Isaline D
Lola T: Diego, Anto
Margaux M: Diego
Sara R: Diego, Arthur S
Alice L: Forest
Alice H: Etienne, Myrdin
Zoé G: Myrdin, Leo O
Noemie: Henri
Valentin: Lison